7 10
**********
*        *
****  ****
*  *  *  *
****  *  *
*     *  *
**********