14 34
**********************************
*  ** *   *   *             *    *
*  ** * * * * *********** ****** *
*  *  * * * *                    *
*  **   *   * ****************** *
*  *************   *   *   *   ***
*  **            *   *   *   *   *
*  ** ************ ***************
*  ** *          *               *
*  ** ************ ***************
*  **              *             *
*  ** ************ *             *
*     *          *               *
**********************************
